10 10
......bbBB
......bbBB
...MM..bbb
..CMM...bb
..MMMM....
.ww..C....
wwww..RRRR
wWWww.R...
wWWww.R.C.
wwww..R...