10 10
..........
..........
...MM.....
..CMM.....
..MMMM....
.....C....
......RRRR
......R...
......R.C.
......R...