12 14
.........wwWWw
.C.......wwWWw
..........wwww
MMMMMM.w...ww.
...C.M........
RRRRRR....RRRR
.........C....
MMMb..b.RRRRRR
.bbbb......MMM
bbBBbb........
bbBBbb...M..C.
.bbbb....M....
