12 14
.........wwWWw
.C.......wwWWw
..........wwww
.MMMMM.w...ww.
...C.M........
RRRRRR....RRRR
.........C....
MMMb..b.RRRRRR
.bbbb......MMM
bbBBbb...R....
bbBBbb...M..C.
.bbbb....M....