10 10
......bbBB
......bbBB
.CMMMM.bbb
...MMM..bb
.....C....
.ww...RRRR
wwww..R...
wWWww.R.C.
wWWww.R...
wwww..R...