12 14
.........wwWWw
.C.......wwWWw
..........wwww
MMMMMM.....ww.
...C.M........
RRRRRR....RRRR
.........C....
MMMM....RRRRRR
.bbbb......MMM
bbBBbb........
bbBBbb...M..C.
.bbbb....M....