18 18
.wwwwww...M....MMM
wwwWWwww......C..M
wwwWWwww.........M
.wwwwww.....M.....
RRRRMMMMM...RRRRRR
RRRRRRRRR...RRRRRR
RRRRR..RM.........
MMMRRRRRM....MMM..
.C..M.RR.....M....
..MM.C.R......C...
RRRRRRRR....MMM...
..................
RRRRRRRRR...RRRRRR
RRRRRRRRR...RRRRRR
bbbbb.......M.....
bBBbbb.....M...C..
bBBbbb............
bbbbb.....M..MMMMM